0000000002000000
0000000002000000
0022222002222200
0020000000000200
2220222222020200
0000000002020000
0000202000000000
0020202222220222
0020000000000200
0022222002222200
0000002000000000
0000002000000000