3000000000000003
0010014004100000
0000044004400010
0001440000441000
0004400000044001
1000000440000000
0000000440000000
0004400000044000
0001440000441000
0100044004400000
0000014004100000
3000000000000103