0003333300000000
0000000000333000
3033003330003300
0000033000300003
0333000030003030
5555555555555555
5555555555555555
3330303033003033
3000300000003000
0030003333300330
0000000033000000
0300333000033000