1000000000000001
0010011001100000
0000011001100010
0001110000111000
0001100000011001
1000000110000000
0000000110000000
0001100000011000
0001110000111000
0100011001100000
0000011001100000
1000000000000101