10000000000000011000000000000001
00100110011000000010011001100000
00000110011000100000011001100010
00011100001110000001110000111000
00011000000110010001100000011001
10000001100000001000000110000000
00000001100000000000000110000000
00011000000110000001100000011000
00011100001110000001110000111000
01000110011000000100011001100000
00000110011000000000011001100000
10000000000001011000000000000101
10000000000000011000000000000001
00100110011000000010011001100000
00000110011000100000011001100010
00011100001110000001110000111000
00011000000110010001100000011001
10000001100000001000000110000000
00000001100000000000000110000000
00011000000110000001100000011000
00011100001110000001110000111000
01000110011000000100011001100000
00000110011000000000011001100000
10000000000001011000000000000101